登陆注册：

	登陆          ----------------------------------------   login.php
	
	注册（手机）     ----------------------------------------   register.php
	
	注册（邮箱）    ----------------------------------------   register2.php
	


整站首页：

	首页          ----------------------------------------   index.php
	
	女模列表       ----------------------------------------   women.php

	首页Tab切换    ----------------------------------------   adswitch.php



模特栏目：

	模特主页       ----------------------------------------   models.php
		
	模特相册       ----------------------------------------   malbums.php
	
	相册详情       ----------------------------------------   malbumdeta.php
	
	个人信息		 ----------------------------------------   personal.php
	
	拍摄评价		 ----------------------------------------   appraisal.php
	
	档期选择       ----------------------------------------   schedule.php



机构栏目：

	机构主页       ----------------------------------------   institutions.php

	机构介绍       ----------------------------------------   introduction.php

	机构作品       ----------------------------------------   works.php

	旗下艺人       ----------------------------------------   artistes.php



通告栏目：

	通告主页       ----------------------------------------   notlce.php



会员中心：	

	会员首页       ----------------------------------------   member.php
	
	互动总览       ----------------------------------------   interactive.php
	
	个人资料	     ----------------------------------------   profile.php
	
	服务价格		 ----------------------------------------   price.php
	
	我的认证       ----------------------------------------   authent.php
	
	作品管理       ----------------------------------------   mworks.php
	
	我的订单       ----------------------------------------   order.php
	
	订单详情       ----------------------------------------   orderdeta.php
	
	资金账户       ----------------------------------------   
	
	交易管理       ----------------------------------------   transaction.php
	
	评论管理       ----------------------------------------   review.php
	
	客户管理       ----------------------------------------   client.php
	
	付款提交       ----------------------------------------   payment.php
	
	站内信        ----------------------------------------   letter.php
	
	待评价        ----------------------------------------   orderapp.php
	
	
	